1111111111111111
1000000C10000C01
1P00000000000001
100000000E000001
1111111111111111